2 4 4 5 4 4 2 2 2 2 2 2 2 2 2 2 2 2 2 2 2 2 2 2 2 2 2 2 2 2 2 2 2 2 2 4 4 5 4 4
2 4 4 5 4 4 2 2 0 0 1 0 0 2 2 0 0 0 0 0 0 0 0 0 0 0 0 0 0 0 0 0 0 2 2 4 4 5 4 4
2 4 4 5 4 4 2 2 0 0 1 0 0 2 2 0 0 0 0 0 0 0 0 0 0 0 0 0 0 0 0 0 0 2 2 4 4 5 4 4
2 4 4 5 4 4 2 2 0 0 1 0 0 2 2 0 0 0 0 0 0 0 0 0 0 0 0 0 0 0 0 0 0 2 2 4 4 5 4 4
2 4 3 5 3 4 2 2 0 0 1 0 0 2 2 0 0 0 0 0 0 0 0 0 0 0 0 0 0 0 0 0 0 2 2 4 3 5 3 4
2 2 2 2 2 2 2 2 0 0 1 0 0 2 2 2 2 2 0 0 0 2 2 2 2 2 0 0 0 2 2 2 2 2 2 2 2 2 2 2
2 0 0 0 0 0 0 0 0 0 1 0 0 0 0 0 0 0 0 0 0 0 0 0 0 0 0 0 0 0 0 0 0 0 0 0 0 0 0 2
2 6 6 6 6 6 6 6 6 6 0 6 6 6 6 6 6 6 6 6 6 6 6 6 6 6 6 6 6 6 6 6 6 6 6 6 6 6 6 2
2 0 0 0 0 0 0 0 0 0 1 0 0 0 0 0 0 0 0 0 0 0 0 0 0 0 0 1 0 0 0 0 0 0 0 0 0 0 0 2
2 2 2 2 2 2 2 2 0 0 1 0 0 2 2 8 8 8 8 8 8 8 8 2 2 0 0 1 0 0 2 2 2 2 2 2 2 2 2 2
2 0 0 0 0 0 0 0 0 0 1 0 0 2 2 8 8 8 8 8 8 8 8 2 2 0 0 1 0 0 2 9 9 9 9 9 9 9 9 2
2 0 0 0 0 0 0 0 0 0 1 0 0 2 2 8 8 8 8 8 8 8 8 2 2 0 0 1 0 0 0 9 9 9 9 9 9 9 9 2
2 9 9 9 9 9 0 0 0 0 1 0 0 2 2 8 8 8 8 8 8 8 8 2 2 0 0 1 0 0 0 9 9 9 9 9 9 9 9 2
2 0 0 0 0 0 0 0 0 0 1 0 0 2 2 8 8 7 8 8 7 8 8 2 2 0 0 1 0 0 0 9 9 9 9 9 9 9 9 2
2 0 0 0 0 0 0 0 0 0 1 0 0 2 2 2 2 2 2 2 2 2 2 2 2 0 0 1 0 0 2 9 9 9 9 9 9 9 9 2
2 2 2 2 2 2 2 2 9 0 1 0 0 0 0 0 0 0 0 0 0 0 0 0 0 0 0 1 0 0 2 2 2 2 2 2 2 2 2 2
2 4 4 5 4 4 5 4 9 0 1 0 0 0 0 0 0 0 0 0 0 0 0 0 0 0 0 1 0 0 0 0 0 0 0 0 0 0 0 2
2 4 4 5 4 4 5 4 9 0 0 6 6 6 6 6 6 6 6 6 6 6 6 6 6 6 6 0 0 0 6 6 6 6 6 6 6 6 6 2
2 4 4 5 4 4 5 4 9 0 0 0 0 0 0 0 0 0 0 0 0 0 0 0 0 0 0 0 0 1 0 0 0 0 0 0 0 0 0 2
2 4 4 5 3 4 5 4 9 0 0 0 0 0 0 2 2 2 2 2 2 2 2 2 2 0 0 0 0 1 0 0 0 0 0 0 0 0 0 2
2 0 0 0 0 0 0 0 0 0 0 0 0 0 0 2 2 2 2 2 2 2 2 2 2 0 0 0 0 1 0 0 4 5 4 4 5 4 4 2
2 6 6 6 6 6 6 6 6 6 6 6 0 0 0 2 2 2 2 2 2 2 2 2 2 0 0 0 0 1 0 0 4 5 4 4 5 4 4 2
2 0 0 0 0 0 0 0 0 0 0 0 1 0 0 0 0 0 0 0 0 0 0 0 0 0 0 0 0 1 0 0 4 5 4 4 5 4 4 2
2 0 0 0 0 0 0 0 0 0 0 0 1 0 0 0 0 0 0 0 0 0 0 0 0 0 0 0 0 1 0 0 4 3 3 3 3 4 4 2
2 2 2 2 2 2 2 2 2 0 0 0 1 0 0 0 0 0 0 0 0 0 0 0 0 0 0 0 0 1 0 0 2 2 2 2 2 2 2 2
2 9 9 9 9 9 9 9 9 0 0 0 1 0 0 2 2 2 2 2 2 2 2 2 2 2 2 0 0 1 0 0 0 0 0 0 0 0 0 2
2 9 9 9 9 9 9 9 9 0 0 0 1 0 0 2 2 8 8 8 8 8 8 8 8 2 2 0 0 1 0 0 0 0 0 0 0 0 0 2
2 9 9 9 9 9 9 9 9 0 0 0 1 0 0 2 2 8 8 8 8 8 8 8 8 2 2 0 0 1 0 0 0 0 9 9 9 9 9 2
2 9 9 9 9 9 9 9 9 0 0 0 1 0 0 2 2 8 8 8 8 8 8 8 8 2 2 0 0 1 0 0 0 0 0 0 0 0 0 2
2 9 9 9 9 9 9 9 9 0 0 0 1 0 0 2 2 8 8 8 7 7 8 8 8 2 2 0 0 1 0 0 0 0 0 0 0 0 0 2
2 2 2 2 2 2 2 2 2 0 0 0 1 0 0 2 2 2 2 2 2 2 2 2 2 2 2 0 0 1 0 0 2 2 2 2 2 2 2 2
2 0 0 0 0 0 0 0 0 0 0 0 1 0 0 0 0 0 0 0 0 0 0 0 0 0 0 0 0 1 0 0 0 0 0 0 0 0 0 2
2 6 6 6 6 6 6 6 6 6 6 6 6 6 6 6 6 6 6 6 6 6 6 6 6 6 6 6 6 0 6 6 6 6 6 6 6 6 6 2
2 0 0 0 0 0 0 0 0 0 0 0 0 0 0 0 0 0 0 0 0 0 0 0 0 0 0 0 0 1 0 0 0 0 0 0 0 0 0 2
2 2 2 2 2 2 2 2 2 2 2 2 2 2 0 0 0 0 0 2 2 2 2 2 2 2 2 0 0 1 0 0 2 2 2 2 2 2 2 2
4 4 5 4 4 2 2 0 0 0 0 0 0 0 0 0 0 0 0 0 0 0 0 0 0 2 2 0 0 1 0 0 2 2 4 4 5 4 4 2
4 4 5 4 4 2 2 0 0 0 0 0 0 0 0 0 0 0 0 0 0 0 0 0 0 2 2 0 0 1 0 0 2 2 4 4 5 4 4 2
4 4 5 4 4 2 2 0 0 0 0 0 0 0 0 0 0 0 0 0 0 0 0 0 0 2 2 0 0 1 0 0 2 2 4 4 5 4 4 2
4 4 5 4 4 2 2 0 0 0 0 0 0 0 0 0 0 0 0 0 0 0 0 0 0 2 2 0 0 1 0 0 2 2 4 4 5 4 4 2
4 4 3 4 4 2 2 2 2 2 2 2 2 2 2 2 2 2 2 2 2 2 2 2 2 2 2 2 2 2 2 2 2 2 4 4 3 4 4 2